S**.......
..*...***.
*.***.*.*.
........*.
.********.
.***....*.
.**..**...
.**...****
..**.**...
*..*....*E